51 51 51 51 51 51 51 51 51 61 61 61 51 44 61 61 61 61 45 51 51 51 51 51 51 51 51 51 51 51
51 51 51 51 51 51 44 61 62 11 11 11 60 62 11 11 11 11 60 45 51 51 51 51 51 51 51 51 51 51
51 51 51 51 44 61 62 11 11 11 11 21 11 11 73 11 11 11 11 60 45 51 51 51 51 51 51 51 51 51
51 51 51 51 62 11 04 21 21 11 21 18 21 21 11 21 21 05 11 11 60 51 51 51 51 51 51 51 51 51
51 51 51 52 11 11 12 18 18 23 18 18 18 18 13 18 18 20 21 05 11 60 45 51 51 51 51 51 51 51
51 51 51 52 11 11 12 18 18 18 18 18 18 18 13 18 18 18 18 20 21 05 60 61 45 51 51 51 51 51
51 51 51 52 11 11 12 18 18 18 18 18 18 18 13 18 18 18 18 18 18 20 11 11 60 61 51 51 51 51
51 51 51 52 11 11 12 18 18 18 18 18 18 18 13 18 18 18 18 18 18 18 21 05 11 11 50 51 51 51
51 51 51 54 42 11 14 02 18 18 18 18 18 18 20 31 31 02 18 18 18 18 18 10 11 11 60 51 51 51
51 51 51 51 52 11 11 14 02 18 18 18 18 18 18 18 18 13 18 18 18 18 18 20 21 05 11 50 51 51
51 51 51 51 54 42 11 11 12 18 18 18 18 18 18 18 18 13 18 18 18 18 18 18 18 10 11 50 51 51
51 51 51 51 51 52 11 11 12 18 18 18 18 18 18 18 18 13 18 18 18 18 18 18 18 10 11 50 51 51
51 51 51 51 44 62 11 04 22 18 18 18 18 18 18 24 28 13 28 28 28 25 18 18 18 10 11 50 51 51
51 51 51 51 52 11 11 12 18 18 18 18 18 18 18 19 64 68 68 68 65 17 18 18 18 20 11 50 51 51
51 51 51 51 52 11 11 22 18 18 18 18 18 18 18 19 59 51 51 51 57 17 18 18 18 18 10 50 51 51
51 51 51 51 52 11 22 18 18 18 18 18 18 18 18 19 59 51 51 51 57 17 18 18 18 18 10 50 51 51
51 51 51 44 62 12 18 18 18 18 18 18 18 18 18 19 59 51 51 51 57 17 18 18 18 01 11 50 51 51
51 51 51 52 11 12 18 18 18 18 18 18 18 18 18 19 74 48 48 48 75 17 18 18 18 11 11 50 51 51
51 51 51 52 11 22 18 18 18 18 18 18 18 18 18 34 08 08 08 08 08 35 18 18 01 11 11 50 51 51
51 51 51 52 12 18 18 18 18 18 00 02 18 18 18 18 18 18 18 18 18 18 18 01 11 11 40 51 51 51
51 51 51 52 12 18 18 18 18 00 15 14 01 01 02 18 18 18 18 18 18 18 00 11 11 40 55 51 51 51
51 51 51 52 12 18 18 18 18 10 11 11 11 11 14 01 02 18 18 18 18 18 10 11 40 55 51 51 51 51
51 51 51 52 12 18 18 18 18 10 11 40 42 11 11 11 12 18 18 18 18 18 10 11 50 51 51 51 51 51
51 51 51 52 12 18 18 18 18 10 11 50 54 41 41 42 14 02 18 18 18 18 10 11 50 51 51 51 51 51
51 51 51 52 14 01 26 01 01 15 11 50 51 51 51 54 42 12 18 18 18 18 10 11 50 51 51 51 51 51
51 51 51 52 11 11 11 11 11 11 40 55 51 51 51 51 52 12 18 18 18 00 11 11 50 51 51 51 51 51
51 51 51 54 42 11 11 11 11 11 50 51 51 51 51 51 51 14 01 01 01 11 11 40 55 51 51 51 51 51
51 51 51 51 52 11 11 11 11 40 55 51 51 51 51 51 51 41 42 11 11 11 40 55 51 51 51 51 51 51
51 51 51 51 54 42 11 11 40 55 51 51 51 51 51 51 51 51 51 41 41 41 51 51 51 51 51 51 51 51
51 51 51 51 51 54 41 41 51 51 51 51 51 51 51 51 51 51 51 51 51 51 51 51 51 51 51 51 51 51
