10 10 10 10 10 10 10 10 10 10
10 10 10 10 25 10 10 10 10 10
10 10 25 25 25 25 25 10 10 10
10 10 25 10 25 10 25 10 10 10
10 25 10 10 25 10 10 25 10 10
10 10 10 10 25 10 10 10 10 10
10 10 10 10 25 10 10 10 10 10
10 10 10 10 25 10 10 10 10 10
10 10 10 10 10 10 10 10 10 10
10 10 10 10 10 10 10 10 10 28